#S########
#+.......#
#.#.######
#.#+######
#.#...####
#.#+######
#.#.######
#.#E######
##########