S....+.##########
######..#########
...####.+########
##.#####.+#..+.##
##.##.....#.##.#
##....###.+.##.##
###.##########+##
########..+.##.##
E...+....##..+.##
#################