#..+..##..S##
#.#.#+##.####
#+#.#....####
#.#.#########
#.#...#######
#+###########
#.#..+#..+###
#...#.#.#.###
#####.#.#..E#
#####...#####